The moonlight covers part of your arm, you wake up confused, with a big headache
Coming Home
An Interactive Fiction by Cecílio, João, Paulo e Vitória
Release 1 / Serial number 190811 / Inform 7 build 6M62 (I6/v6.33 lib 6/12N) SD

Large Bedroom
A large bedroom with a queen size bed at its center, with one bedside lamp at the right of the bed. Its really dark, the only light on the room is the faint light from the window. 

You can see Pile of clothes, Picture Portrait, Bedside lamp and Mirror here.

>examine bedside lamp
A lamp used to give some minor light on the room

You turn it on. Now you can see the room more clearly, and there are a body in the ground

>look
Large Bedroom
A large bedroom with a queen size bed at its center, with one bedside lamp at the right of the bed.  You can see a big room, and a body is laid down on the ground.

You can see Dead body, Pile of clothes, Picture Portrait and Bedside lamp here.

* * *

The moonlight covers part of your arm, you wake up confused, with a big headache
Coming Home
An Interactive Fiction by Cecílio, João, Paulo e Vitória
Release 1 / Serial number 190811 / Inform 7 build 6M62 (I6/v6.33 lib 6/12N) SD

Large Bedroom
A large bedroom with a queen size bed at its center, with one bedside lamp at the right of the bed. Its really dark, the only light on the room is the faint light from the window. 

You can see Pile of clothes, Picture Portrait, Bedside lamp and Mirror here.

>examine box
In Old box are candle and string.

* * *

The moonlight covers part of your arm, you wake up confused, with a big headache
Coming Home
An Interactive Fiction by Cecílio, João, Paulo e Vitória
Release 1 / Serial number 190811 / Inform 7 build 6M62 (I6/v6.33 lib 6/12N) SD

Large Bedroom
A large bedroom with a queen size bed at its center, with one bedside lamp at the right of the bed. Its really dark, the only light on the room is the faint light from the window. 

You can see Pile of clothes, Picture Portrait, Bedside lamp and Mirror here.

>examine pile of clothes
A pile of dirty clothes. It stinks of sweat and alcohol.

>examine picture portrait
You can see you in a party with some people, with a blonde woman at your side. You look really happy and satisfied to be there.

>search pile of clothes
You find nothing of interest.

>search bedside lamp
You find nothing of interest.

>exaine bedside lamp
That's not a verb I recognise.

>examine bedside lamp
A lamp used to give some minor light on the room

You turn it on. After some seconds getting used to the light you can see the room more clearly, and there is a body in the ground. There's blood around the body.

>look
Large Bedroom
A large bedroom with a queen size bed at its center, with one bedside lamp at the right of the bed.  You can see a big room, and a body is laid down on the ground.

You can see Dead body, Pile of clothes, Picture Portrait, Bedside lamp and Mirror here.

>examine dead body
 A dead body of a blonde woman. It's the same woman in the portrait. You feel a strange and intense sadness. You look around and see more pictures of her. She was really important to you. There's something behind her. 

Looking more closely you see a woman bag near the bed

>look
Large Bedroom
A large bedroom with a queen size bed at its center, with one bedside lamp at the right of the bed.  You can see a big room, and a body is laid down on the ground.

You can see Woman bag (in which are Car key, Driver License and Phone), Dead body, Pile of clothes, Picture Portrait, Bedside lamp and Mirror here.

>pick woman bag
I didn't understand that sentence.

>pick car key
I didn't understand that sentence.

>examine woman bag
You find some items of common use by woman, a key and a driver license

In Woman bag are Car key, Driver License and Phone.

>pick Car key
I didn't understand that sentence.

>take car key
Taken.

>take Phone
Taken.

>take Driver License
Taken.

>inventory
You are carrying:
  Driver License
  Phone
  Car key

>examine Driver License
A Driver License from the victim. Her name is Katherine.

História aqui do primeiro Flashback

* * *

>take car key
Taken.

>take driver licens
I only understood you as far as wanting to take Driver License.

>take driver license
Taken.

>inventory
You are carrying:
  Driver License
  Car key

* * *

>take driver license
Taken.

>take phone
Taken.

>inventory
You are carrying:
  Phone
  Driver License
  Car key

* * *

>examine woman bag
You find some items of common use by woman, a key and a driver license

In Woman bag are Car key, Driver License and Phone.

>take Car key
Taken.

>take Phone
Taken.

>take Driver License
Taken.

História do primeiro Flashback

* * *

The moonlight covers part of your arm, you wake up confused, with a big headache
Coming Home
An Interactive Fiction by Cecílio, João, Paulo e Vitória
Release 1 / Serial number 190811 / Inform 7 build 6M62 (I6/v6.33 lib 6/12N) SD

Large Bedroom
A large bedroom with a queen size bed at its center, with one bedside lamp at the right of the bed. Its really dark, the only light on the room is the faint light from the window. 

You can see Pile of clothes, Picture Portrait, Bedside lamp and Mirror here.

>look
Large Bedroom
A large bedroom with a queen size bed at its center, with one bedside lamp at the right of the bed. Its really dark, the only light on the room is the faint light from the window. 

You can see Pile of clothes, Picture Portrait and Bedside lamp here.

>examine Picture portrait
You can see you in a party, with a blonde woman at your side

>examine bedside lamp
A lamp used to give some minor light on the room

You turn it on. Now you can see the room more clearly, and there are a body in the ground

>examine deadbody
You can't see any such thing.

>examine dead body
 A dead body of a blonde woman. It's the same woman in the portrait. You feel a strange and intense sadness. She was really important to you.

* * *

>look
Large Bedroom
A large bedroom with a queen size bed at its center, with one bedside lamp at the right of the bed. Its really dark, the only light on the room is the faint light from the window. 

You can see Pile of clothes, Picture Portrait and Bedside lamp here.

>examine Pile of Clothes
A pile of dirty clothes